---- 	   	Begin Recorded Data	   	 ---- 
time 	 | 	robot 	| 	 goal 
1 = target	 0 = base 
 
0 	 | 	fb1 	 | 	1
0 	 | 	fb2 	 | 	1
0 	 | 	fb3 	 | 	1
0 	 | 	fb3 	 | 	1
0 	 | 	fb4 	 | 	1
0 	 | 	fb5 	 | 	1
0 	 | 	fb6 	 | 	1
0 	 | 	fb7 	 | 	1
0 	 | 	fb7 	 | 	1
0 	 | 	fb8 	 | 	1
0 	 | 	fb9 	 | 	1
0 	 | 	fb10 	 | 	1
0 	 | 	fb11 	 | 	1
0 	 | 	fb12 	 | 	1
0 	 | 	fb13 	 | 	1
0 	 | 	fb14 	 | 	1
0 	 | 	fb15 	 | 	1
0 	 | 	fb16 	 | 	1
0 	 | 	fb17 	 | 	1
0 	 | 	fb18 	 | 	1
0 	 | 	fb18 	 | 	1
0 	 | 	fb19 	 | 	1
0 	 | 	fb20 	 | 	1
0 	 | 	fb20 	 | 	1
0 	 | 	fb20 	 | 	1
0 	 | 	fb21 	 | 	1
0 	 | 	fb22 	 | 	1
0 	 | 	fb22 	 | 	1
0 	 | 	fb22 	 | 	1
0 	 | 	fb23 	 | 	1
0 	 | 	fb24 	 | 	1
0 	 | 	fb25 	 | 	1
0 	 | 	fb25 	 | 	1
0 	 | 	fb26 	 | 	1
0 	 | 	fb26 	 | 	1
0 	 | 	fb26 	 | 	1
0 	 | 	fb26 	 | 	1
0 	 | 	fb27 	 | 	1
0 	 | 	fb28 	 | 	1
0 	 | 	fb29 	 | 	1
0 	 | 	fb30 	 | 	1
0 	 | 	fb31 	 | 	1
0 	 | 	fb32 	 | 	1
0 	 | 	fb32 	 | 	1
0 	 | 	fb32 	 | 	1
0 	 | 	fb32 	 | 	1
0 	 | 	fb33 	 | 	1
0 	 | 	fb34 	 | 	1
0 	 | 	fb35 	 | 	1
0 	 | 	fb35 	 | 	1
0 	 | 	fb35 	 | 	1
0 	 | 	fb35 	 | 	1
0 	 | 	fb36 	 | 	1
0 	 | 	fb36 	 | 	1
0 	 | 	fb36 	 | 	1
0 	 | 	fb36 	 | 	1
0 	 | 	fb36 	 | 	1
0 	 | 	fb37 	 | 	1
0 	 | 	fb38 	 | 	1
0 	 | 	fb38 	 | 	1
0 	 | 	fb38 	 | 	1
0 	 | 	fb38 	 | 	1
0 	 | 	fb39 	 | 	1
0 	 | 	fb39 	 | 	1
0 	 | 	fb39 	 | 	1
0 	 | 	fb39 	 | 	1
0 	 | 	fb39 	 | 	1
0 	 | 	fb40 	 | 	1
0 	 | 	fb40 	 | 	1
0 	 | 	fb40 	 | 	1
0 	 | 	fb41 	 | 	1
0 	 | 	fb41 	 | 	1
0 	 | 	fb41 	 | 	1
0 	 | 	fb42 	 | 	1
0 	 | 	fb43 	 | 	1
0 	 | 	fb44 	 | 	1
0 	 | 	fb45 	 | 	1
0 	 | 	fb45 	 | 	1
0 	 | 	fb45 	 | 	1
0 	 | 	fb45 	 | 	1
0 	 | 	fb45 	 | 	1
0 	 | 	fb45 	 | 	1
0 	 | 	fb45 	 | 	1
0 	 | 	fb45 	 | 	1
0 	 | 	fb46 	 | 	1
0 	 | 	fb46 	 | 	1
0 	 | 	fb47 	 | 	1
0 	 | 	fb47 	 | 	1
0 	 | 	fb47 	 | 	1
0 	 | 	fb47 	 | 	1
0 	 | 	fb47 	 | 	1
0 	 | 	fb47 	 | 	1
0 	 | 	fb47 	 | 	1
0 	 | 	fb47 	 | 	1
0 	 | 	fb47 	 | 	1
0 	 | 	fb47 	 | 	1
0 	 | 	fb47 	 | 	1
0 	 | 	fb48 	 | 	1
0 	 | 	fb48 	 | 	1
0 	 | 	fb48 	 | 	1
0 	 | 	fb48 	 | 	1
0 	 | 	fb48 	 | 	1
0 	 | 	fb49 	 | 	1
0 	 | 	fb50 	 | 	1
0 	 | 	fb51 	 | 	1
0 	 | 	fb52 	 | 	1
0 	 | 	fb52 	 | 	1
0 	 | 	fb52 	 | 	1
0 	 | 	fb52 	 | 	1
0 	 | 	fb52 	 | 	1
0 	 | 	fb52 	 | 	1
0 	 | 	fb52 	 | 	1
0 	 | 	fb52 	 | 	1
0 	 | 	fb53 	 | 	1
0 	 | 	fb53 	 | 	1
0 	 | 	fb53 	 | 	1
0 	 | 	fb54 	 | 	1
0 	 | 	fb55 	 | 	1
0 	 | 	fb55 	 | 	1
0 	 | 	fb55 	 | 	1
0 	 | 	fb55 	 | 	1
0 	 | 	fb56 	 | 	1
0 	 | 	fb56 	 | 	1
0 	 | 	fb56 	 | 	1
0 	 | 	fb56 	 | 	1
0 	 | 	fb56 	 | 	1
0 	 | 	fb57 	 | 	1
0 	 | 	fb58 	 | 	1
0 	 | 	fb58 	 | 	1
0 	 | 	fb58 	 | 	1
0 	 | 	fb58 	 | 	1
0 	 | 	fb58 	 | 	1
0 	 | 	fb59 	 | 	1
0 	 | 	fb59 	 | 	1
0 	 | 	fb59 	 | 	1
0 	 | 	fb59 	 | 	1
0 	 | 	fb59 	 | 	1
0 	 | 	fb59 	 | 	1
0 	 | 	fb59 	 | 	1
0 	 | 	fb60 	 | 	1
0 	 | 	fb60 	 | 	1
0 	 | 	fb60 	 | 	1
0 	 | 	fb60 	 | 	1
0 	 | 	fb60 	 | 	1
0 	 | 	fb60 	 | 	1
0 	 | 	fb60 	 | 	1
0 	 | 	fb61 	 | 	1
0 	 | 	fb61 	 | 	1
0 	 | 	fb61 	 | 	1
0 	 | 	fb61 	 | 	1
0 	 | 	fb61 	 | 	1
0 	 | 	fb62 	 | 	1
0 	 | 	fb62 	 | 	1
0 	 | 	fb62 	 | 	1
0 	 | 	fb63 	 | 	1
0 	 | 	fb63 	 | 	1
0 	 | 	fb63 	 | 	1
0 	 | 	fb64 	 | 	1
0 	 | 	fb64 	 | 	1
0 	 | 	fb64 	 | 	1
0 	 | 	fb64 	 | 	1
0 	 | 	fb64 	 | 	1
3099 	 | 	fb24 	 | 	0
3409 	 | 	fb12 	 | 	0
5681 	 | 	fb5 	 | 	0
6029 	 | 	fb24 	 | 	1
6188 	 | 	fb37 	 | 	0
6292 	 | 	fb26 	 | 	0
7261 	 | 	fb60 	 | 	0
7835 	 | 	fb48 	 | 	0
8700 	 | 	fb41 	 | 	0
8733 	 | 	fb62 	 | 	0
9298 	 | 	fb6 	 | 	0
9834 	 | 	fb4 	 | 	0
11543 	 | 	fb51 	 | 	0
11770 	 | 	fb64 	 | 	0
13164 	 | 	fb20 	 | 	0
14745 	 | 	fb43 	 | 	0
14816 	 | 	fb56 	 | 	0
17044 	 | 	fb10 	 | 	0
17236 	 | 	fb54 	 | 	0
17444 	 | 	fb40 	 | 	0
17933 	 | 	fb60 	 | 	1
18186 	 | 	fb63 	 | 	0
18467 	 | 	fb28 	 | 	0
18823 	 | 	fb1 	 | 	0
