---- 	   	Begin Recorded Data	   	 ---- 
time 	 | 	robot 	| 	 goal 
1 = target	 0 = base 
 
0 	 | 	fb1 	 | 	1
0 	 | 	fb2 	 | 	1
0 	 | 	fb3 	 | 	1
0 	 | 	fb4 	 | 	1
0 	 | 	fb5 	 | 	1
0 	 | 	fb6 	 | 	1
0 	 | 	fb7 	 | 	1
0 	 | 	fb7 	 | 	1
0 	 | 	fb8 	 | 	1
0 	 | 	fb9 	 | 	1
0 	 | 	fb10 	 | 	1
0 	 | 	fb11 	 | 	1
0 	 | 	fb12 	 | 	1
0 	 | 	fb13 	 | 	1
0 	 | 	fb14 	 | 	1
0 	 | 	fb15 	 | 	1
0 	 | 	fb16 	 | 	1
0 	 | 	fb17 	 | 	1
0 	 | 	fb17 	 | 	1
0 	 | 	fb17 	 | 	1
0 	 | 	fb17 	 | 	1
0 	 | 	fb17 	 | 	1
0 	 | 	fb17 	 | 	1
0 	 | 	fb18 	 | 	1
0 	 | 	fb18 	 | 	1
0 	 | 	fb19 	 | 	1
0 	 | 	fb20 	 | 	1
0 	 | 	fb21 	 | 	1
0 	 | 	fb21 	 | 	1
0 	 | 	fb21 	 | 	1
0 	 | 	fb21 	 | 	1
0 	 | 	fb21 	 | 	1
0 	 | 	fb21 	 | 	1
0 	 | 	fb21 	 | 	1
0 	 | 	fb22 	 | 	1
0 	 | 	fb23 	 | 	1
0 	 | 	fb23 	 | 	1
0 	 | 	fb24 	 | 	1
0 	 | 	fb25 	 | 	1
0 	 | 	fb25 	 | 	1
0 	 | 	fb26 	 | 	1
0 	 | 	fb27 	 | 	1
0 	 | 	fb28 	 | 	1
0 	 | 	fb28 	 | 	1
0 	 | 	fb28 	 | 	1
0 	 | 	fb29 	 | 	1
0 	 | 	fb29 	 | 	1
0 	 | 	fb30 	 | 	1
0 	 | 	fb30 	 | 	1
0 	 | 	fb30 	 | 	1
0 	 | 	fb31 	 | 	1
0 	 | 	fb32 	 | 	1
0 	 | 	fb32 	 | 	1
0 	 | 	fb33 	 | 	1
0 	 | 	fb34 	 | 	1
0 	 | 	fb35 	 | 	1
0 	 | 	fb36 	 | 	1
0 	 | 	fb36 	 | 	1
0 	 | 	fb37 	 | 	1
0 	 | 	fb37 	 | 	1
0 	 | 	fb38 	 | 	1
0 	 | 	fb38 	 | 	1
0 	 | 	fb38 	 | 	1
0 	 | 	fb38 	 | 	1
0 	 | 	fb38 	 | 	1
0 	 | 	fb38 	 | 	1
0 	 | 	fb38 	 | 	1
0 	 | 	fb39 	 | 	1
0 	 | 	fb40 	 | 	1
0 	 | 	fb40 	 | 	1
0 	 | 	fb40 	 | 	1
0 	 | 	fb40 	 | 	1
0 	 | 	fb40 	 | 	1
0 	 | 	fb41 	 | 	1
0 	 | 	fb42 	 | 	1
0 	 | 	fb42 	 | 	1
0 	 | 	fb42 	 | 	1
0 	 | 	fb43 	 | 	1
0 	 | 	fb44 	 | 	1
0 	 | 	fb44 	 | 	1
0 	 | 	fb45 	 | 	1
0 	 | 	fb45 	 | 	1
0 	 | 	fb46 	 | 	1
0 	 | 	fb46 	 | 	1
0 	 | 	fb46 	 | 	1
0 	 | 	fb46 	 | 	1
0 	 | 	fb46 	 | 	1
0 	 | 	fb46 	 | 	1
0 	 | 	fb46 	 | 	1
0 	 | 	fb47 	 | 	1
0 	 | 	fb47 	 | 	1
0 	 | 	fb47 	 | 	1
0 	 | 	fb47 	 | 	1
0 	 | 	fb48 	 | 	1
0 	 | 	fb49 	 | 	1
0 	 | 	fb49 	 | 	1
0 	 | 	fb50 	 | 	1
0 	 | 	fb51 	 | 	1
0 	 | 	fb52 	 | 	1
0 	 | 	fb52 	 | 	1
0 	 | 	fb52 	 | 	1
0 	 | 	fb52 	 | 	1
0 	 | 	fb52 	 | 	1
0 	 | 	fb52 	 | 	1
0 	 | 	fb52 	 | 	1
0 	 | 	fb52 	 | 	1
0 	 | 	fb53 	 | 	1
0 	 | 	fb53 	 | 	1
0 	 | 	fb53 	 | 	1
0 	 | 	fb53 	 | 	1
0 	 | 	fb53 	 | 	1
0 	 | 	fb53 	 | 	1
0 	 | 	fb53 	 | 	1
0 	 | 	fb54 	 | 	1
0 	 | 	fb54 	 | 	1
0 	 | 	fb54 	 | 	1
0 	 | 	fb54 	 | 	1
0 	 | 	fb54 	 | 	1
0 	 | 	fb54 	 | 	1
0 	 | 	fb54 	 | 	1
0 	 | 	fb54 	 | 	1
0 	 | 	fb54 	 | 	1
0 	 | 	fb55 	 | 	1
0 	 | 	fb55 	 | 	1
0 	 | 	fb56 	 | 	1
0 	 | 	fb56 	 | 	1
0 	 | 	fb56 	 | 	1
0 	 | 	fb57 	 | 	1
0 	 | 	fb57 	 | 	1
0 	 | 	fb57 	 | 	1
0 	 | 	fb57 	 | 	1
0 	 | 	fb58 	 | 	1
0 	 | 	fb58 	 | 	1
0 	 | 	fb58 	 | 	1
0 	 | 	fb58 	 | 	1
0 	 | 	fb58 	 | 	1
0 	 | 	fb58 	 | 	1
0 	 | 	fb58 	 | 	1
0 	 | 	fb58 	 | 	1
0 	 | 	fb58 	 | 	1
0 	 | 	fb59 	 | 	1
0 	 | 	fb60 	 | 	1
0 	 | 	fb60 	 | 	1
0 	 | 	fb60 	 | 	1
0 	 | 	fb61 	 | 	1
0 	 | 	fb62 	 | 	1
0 	 | 	fb62 	 | 	1
0 	 | 	fb63 	 | 	1
0 	 | 	fb63 	 | 	1
0 	 | 	fb63 	 | 	1
0 	 | 	fb63 	 | 	1
0 	 | 	fb63 	 | 	1
0 	 | 	fb63 	 | 	1
0 	 | 	fb64 	 | 	1
0 	 | 	fb64 	 | 	1
0 	 | 	fb64 	 | 	1
0 	 | 	fb64 	 | 	1
3210 	 | 	fb40 	 | 	0
3831 	 | 	fb49 	 | 	0
5004 	 | 	fb61 	 | 	0
5100 	 | 	fb41 	 | 	0
5812 	 | 	fb46 	 | 	0
5828 	 | 	fb23 	 | 	0
7576 	 | 	fb62 	 | 	0
7742 	 | 	fb59 	 | 	0
7995 	 | 	fb57 	 | 	0
8527 	 | 	fb43 	 | 	0
8594 	 | 	fb30 	 | 	0
8920 	 | 	fb42 	 | 	0
11562 	 | 	fb43 	 | 	1
12101 	 | 	fb53 	 | 	0
12189 	 | 	fb14 	 | 	0
12395 	 | 	fb12 	 | 	0
12736 	 | 	fb45 	 | 	0
13297 	 | 	fb15 	 | 	0
13826 	 | 	fb4 	 | 	0
14135 	 | 	fb51 	 | 	0
14364 	 | 	fb58 	 | 	0
14465 	 | 	fb28 	 | 	0
14475 	 | 	fb2 	 | 	0
14776 	 | 	fb32 	 | 	0
15118 	 | 	fb43 	 | 	0
15668 	 | 	fb23 	 | 	1
15957 	 | 	fb3 	 | 	0
16402 	 | 	fb13 	 | 	0
16490 	 | 	fb34 	 | 	0
17804 	 | 	fb47 	 | 	0
17901 	 | 	fb38 	 | 	0
17985 	 | 	fb40 	 | 	1
18590 	 | 	fb39 	 | 	0
18799 	 | 	fb55 	 | 	0
18963 	 | 	fb56 	 | 	0
19161 	 | 	fb26 	 | 	0
