---- 	   	Begin Recorded Data	   	 ---- 
time 	 | 	robot 	| 	 goal 
1 = target	 0 = base 
 
0 	 | 	fb1 	 | 	1
0 	 | 	fb2 	 | 	1
0 	 | 	fb3 	 | 	1
0 	 | 	fb4 	 | 	1
0 	 | 	fb5 	 | 	1
0 	 | 	fb5 	 | 	1
0 	 | 	fb6 	 | 	1
0 	 | 	fb7 	 | 	1
0 	 | 	fb8 	 | 	1
0 	 | 	fb9 	 | 	1
0 	 | 	fb10 	 | 	1
0 	 | 	fb11 	 | 	1
0 	 | 	fb12 	 | 	1
0 	 | 	fb13 	 | 	1
0 	 | 	fb14 	 | 	1
0 	 | 	fb14 	 | 	1
0 	 | 	fb15 	 | 	1
0 	 | 	fb15 	 | 	1
0 	 | 	fb15 	 | 	1
0 	 | 	fb15 	 | 	1
0 	 | 	fb15 	 | 	1
0 	 | 	fb15 	 | 	1
0 	 | 	fb15 	 | 	1
0 	 | 	fb16 	 | 	1
0 	 | 	fb16 	 | 	1
0 	 | 	fb17 	 | 	1
0 	 | 	fb18 	 | 	1
0 	 | 	fb18 	 | 	1
0 	 | 	fb18 	 | 	1
0 	 | 	fb19 	 | 	1
0 	 | 	fb20 	 | 	1
0 	 | 	fb20 	 | 	1
0 	 | 	fb21 	 | 	1
0 	 | 	fb22 	 | 	1
0 	 | 	fb22 	 | 	1
0 	 | 	fb23 	 | 	1
0 	 | 	fb24 	 | 	1
0 	 | 	fb24 	 | 	1
0 	 | 	fb25 	 | 	1
0 	 | 	fb26 	 | 	1
0 	 | 	fb27 	 | 	1
0 	 | 	fb27 	 | 	1
0 	 | 	fb28 	 | 	1
0 	 | 	fb29 	 | 	1
0 	 | 	fb29 	 | 	1
0 	 | 	fb29 	 | 	1
0 	 | 	fb30 	 | 	1
0 	 | 	fb30 	 | 	1
0 	 | 	fb30 	 | 	1
0 	 | 	fb31 	 | 	1
0 	 | 	fb31 	 | 	1
0 	 | 	fb31 	 | 	1
0 	 | 	fb31 	 | 	1
0 	 | 	fb32 	 | 	1
0 	 | 	fb33 	 | 	1
0 	 | 	fb34 	 | 	1
0 	 | 	fb34 	 | 	1
0 	 | 	fb34 	 | 	1
0 	 | 	fb34 	 | 	1
0 	 | 	fb35 	 | 	1
0 	 | 	fb35 	 | 	1
0 	 | 	fb36 	 | 	1
0 	 | 	fb37 	 | 	1
0 	 | 	fb38 	 | 	1
0 	 | 	fb38 	 | 	1
0 	 | 	fb38 	 | 	1
0 	 | 	fb38 	 | 	1
0 	 | 	fb39 	 | 	1
0 	 | 	fb40 	 | 	1
0 	 | 	fb41 	 | 	1
0 	 | 	fb42 	 | 	1
0 	 | 	fb43 	 | 	1
0 	 | 	fb44 	 | 	1
0 	 | 	fb45 	 | 	1
0 	 | 	fb45 	 | 	1
0 	 | 	fb45 	 | 	1
0 	 | 	fb45 	 | 	1
0 	 | 	fb45 	 | 	1
0 	 | 	fb46 	 | 	1
0 	 | 	fb46 	 | 	1
0 	 | 	fb47 	 | 	1
0 	 | 	fb48 	 | 	1
0 	 | 	fb48 	 | 	1
0 	 | 	fb49 	 | 	1
0 	 | 	fb49 	 | 	1
0 	 | 	fb49 	 | 	1
0 	 | 	fb49 	 | 	1
0 	 | 	fb49 	 | 	1
0 	 | 	fb49 	 | 	1
0 	 | 	fb49 	 | 	1
0 	 | 	fb49 	 | 	1
0 	 | 	fb49 	 | 	1
0 	 | 	fb50 	 | 	1
0 	 | 	fb51 	 | 	1
0 	 | 	fb52 	 | 	1
0 	 | 	fb53 	 | 	1
0 	 | 	fb54 	 | 	1
0 	 | 	fb54 	 | 	1
0 	 | 	fb54 	 | 	1
0 	 | 	fb54 	 | 	1
0 	 | 	fb55 	 | 	1
0 	 | 	fb56 	 | 	1
0 	 | 	fb56 	 | 	1
0 	 | 	fb56 	 | 	1
0 	 | 	fb56 	 | 	1
0 	 | 	fb56 	 | 	1
0 	 | 	fb57 	 | 	1
0 	 | 	fb57 	 | 	1
0 	 | 	fb57 	 | 	1
0 	 | 	fb57 	 | 	1
0 	 | 	fb58 	 | 	1
0 	 | 	fb58 	 | 	1
0 	 | 	fb58 	 | 	1
0 	 | 	fb58 	 | 	1
0 	 | 	fb58 	 | 	1
0 	 | 	fb58 	 | 	1
0 	 | 	fb58 	 | 	1
0 	 | 	fb58 	 | 	1
0 	 | 	fb58 	 | 	1
0 	 | 	fb59 	 | 	1
0 	 | 	fb59 	 | 	1
0 	 | 	fb60 	 | 	1
0 	 | 	fb60 	 | 	1
0 	 | 	fb61 	 | 	1
0 	 | 	fb62 	 | 	1
0 	 | 	fb62 	 | 	1
0 	 | 	fb62 	 | 	1
0 	 | 	fb62 	 | 	1
0 	 | 	fb62 	 | 	1
0 	 | 	fb62 	 | 	1
0 	 | 	fb62 	 | 	1
0 	 | 	fb62 	 | 	1
0 	 | 	fb62 	 | 	1
0 	 | 	fb62 	 | 	1
0 	 | 	fb62 	 | 	1
0 	 | 	fb63 	 | 	1
0 	 | 	fb64 	 | 	1
0 	 | 	fb65 	 | 	1
0 	 | 	fb65 	 | 	1
0 	 | 	fb65 	 | 	1
0 	 | 	fb65 	 | 	1
0 	 | 	fb65 	 | 	1
0 	 | 	fb66 	 | 	1
0 	 | 	fb66 	 | 	1
0 	 | 	fb66 	 | 	1
0 	 | 	fb66 	 | 	1
0 	 | 	fb66 	 | 	1
0 	 | 	fb66 	 | 	1
0 	 | 	fb66 	 | 	1
0 	 | 	fb66 	 | 	1
0 	 | 	fb66 	 | 	1
0 	 | 	fb66 	 | 	1
0 	 | 	fb66 	 | 	1
0 	 | 	fb67 	 | 	1
0 	 | 	fb67 	 | 	1
0 	 | 	fb67 	 | 	1
0 	 | 	fb67 	 | 	1
0 	 | 	fb67 	 | 	1
0 	 | 	fb67 	 | 	1
0 	 | 	fb67 	 | 	1
0 	 | 	fb67 	 | 	1
0 	 | 	fb67 	 | 	1
0 	 | 	fb67 	 | 	1
0 	 | 	fb67 	 | 	1
0 	 | 	fb67 	 | 	1
0 	 | 	fb67 	 | 	1
0 	 | 	fb67 	 | 	1
0 	 | 	fb67 	 | 	1
0 	 | 	fb67 	 | 	1
0 	 | 	fb67 	 | 	1
0 	 | 	fb67 	 | 	1
0 	 | 	fb68 	 | 	1
0 	 | 	fb69 	 | 	1
0 	 | 	fb69 	 | 	1
0 	 | 	fb70 	 | 	1
0 	 | 	fb71 	 | 	1
0 	 | 	fb71 	 | 	1
0 	 | 	fb72 	 | 	1
0 	 | 	fb73 	 | 	1
0 	 | 	fb73 	 | 	1
0 	 | 	fb73 	 | 	1
0 	 | 	fb74 	 | 	1
0 	 | 	fb74 	 | 	1
0 	 | 	fb75 	 | 	1
0 	 | 	fb75 	 | 	1
0 	 | 	fb76 	 | 	1
0 	 | 	fb76 	 | 	1
0 	 | 	fb76 	 | 	1
0 	 | 	fb76 	 | 	1
0 	 | 	fb77 	 | 	1
0 	 | 	fb77 	 | 	1
0 	 | 	fb77 	 | 	1
0 	 | 	fb77 	 | 	1
0 	 | 	fb77 	 | 	1
0 	 | 	fb77 	 | 	1
0 	 | 	fb77 	 | 	1
0 	 | 	fb77 	 | 	1
0 	 | 	fb78 	 | 	1
0 	 | 	fb78 	 | 	1
0 	 | 	fb78 	 | 	1
0 	 | 	fb79 	 | 	1
0 	 | 	fb79 	 | 	1
0 	 | 	fb79 	 | 	1
0 	 | 	fb79 	 | 	1
0 	 | 	fb79 	 | 	1
0 	 | 	fb79 	 | 	1
0 	 | 	fb79 	 | 	1
0 	 | 	fb80 	 | 	1
0 	 | 	fb80 	 | 	1
0 	 | 	fb80 	 | 	1
0 	 | 	fb80 	 | 	1
0 	 | 	fb80 	 | 	1
0 	 | 	fb80 	 | 	1
2043 	 | 	fb73 	 | 	0
2657 	 | 	fb21 	 | 	0
2926 	 | 	fb14 	 | 	0
3298 	 | 	fb5 	 | 	0
3701 	 | 	fb54 	 | 	0
4542 	 | 	fb8 	 | 	0
4979 	 | 	fb75 	 | 	0
5896 	 | 	fb14 	 | 	1
6115 	 | 	fb69 	 | 	0
6830 	 | 	fb27 	 | 	0
7010 	 | 	fb52 	 | 	0
8123 	 | 	fb63 	 | 	0
8541 	 | 	fb68 	 | 	0
9373 	 | 	fb60 	 | 	0
11169 	 | 	fb31 	 | 	0
11247 	 | 	fb36 	 | 	0
11449 	 | 	fb51 	 | 	0
11516 	 | 	fb19 	 | 	0
11602 	 | 	fb58 	 | 	0
11746 	 | 	fb27 	 | 	1
13042 	 | 	fb34 	 | 	0
13213 	 | 	fb2 	 | 	0
13691 	 | 	fb69 	 | 	1
13803 	 | 	fb63 	 | 	1
14332 	 | 	fb23 	 | 	0
14369 	 | 	fb21 	 | 	1
14733 	 | 	fb25 	 | 	0
14858 	 | 	fb55 	 | 	0
14876 	 | 	fb36 	 | 	1
15031 	 | 	fb6 	 | 	0
15048 	 | 	fb56 	 | 	0
15845 	 | 	fb43 	 | 	0
16144 	 | 	fb57 	 | 	0
16171 	 | 	fb5 	 | 	1
16285 	 | 	fb42 	 | 	0
16843 	 | 	fb59 	 | 	0
16886 	 | 	fb8 	 | 	1
17963 	 | 	fb28 	 | 	0
18492 	 | 	fb31 	 | 	1
18646 	 | 	fb2 	 | 	1
18805 	 | 	fb23 	 | 	1
19425 	 | 	fb39 	 | 	0
19482 	 | 	fb71 	 | 	0
19596 	 | 	fb78 	 | 	0
19794 	 | 	fb32 	 | 	0
19891 	 | 	fb51 	 | 	1
