---- 	   	Begin Recorded Data	   	 ---- 
time 	 | 	robot 	| 	 goal 
1 = target	 0 = base 
 
0 	 | 	fb1 	 | 	1
0 	 | 	fb2 	 | 	1
0 	 | 	fb3 	 | 	1
0 	 | 	fb4 	 | 	1
0 	 | 	fb5 	 | 	1
0 	 | 	fb6 	 | 	1
0 	 | 	fb7 	 | 	1
0 	 | 	fb7 	 | 	1
0 	 | 	fb8 	 | 	1
0 	 | 	fb9 	 | 	1
0 	 | 	fb9 	 | 	1
0 	 | 	fb10 	 | 	1
0 	 | 	fb10 	 | 	1
0 	 | 	fb11 	 | 	1
0 	 | 	fb12 	 | 	1
0 	 | 	fb13 	 | 	1
0 	 | 	fb14 	 | 	1
0 	 | 	fb15 	 | 	1
0 	 | 	fb16 	 | 	1
0 	 | 	fb16 	 | 	1
0 	 | 	fb17 	 | 	1
0 	 | 	fb18 	 | 	1
0 	 | 	fb18 	 | 	1
0 	 | 	fb18 	 | 	1
0 	 | 	fb19 	 | 	1
0 	 | 	fb20 	 | 	1
0 	 | 	fb20 	 | 	1
0 	 | 	fb21 	 | 	1
0 	 | 	fb22 	 | 	1
0 	 | 	fb22 	 | 	1
0 	 | 	fb23 	 | 	1
0 	 | 	fb23 	 | 	1
0 	 | 	fb23 	 | 	1
0 	 | 	fb23 	 | 	1
0 	 | 	fb24 	 | 	1
0 	 | 	fb24 	 | 	1
0 	 | 	fb25 	 | 	1
0 	 | 	fb25 	 | 	1
0 	 | 	fb26 	 | 	1
0 	 | 	fb26 	 | 	1
0 	 | 	fb27 	 | 	1
0 	 | 	fb27 	 | 	1
0 	 | 	fb27 	 | 	1
0 	 | 	fb27 	 | 	1
0 	 | 	fb27 	 | 	1
0 	 | 	fb27 	 | 	1
0 	 | 	fb28 	 | 	1
0 	 | 	fb29 	 | 	1
0 	 | 	fb30 	 | 	1
0 	 | 	fb31 	 | 	1
0 	 | 	fb32 	 | 	1
0 	 | 	fb33 	 | 	1
0 	 | 	fb33 	 | 	1
0 	 | 	fb33 	 | 	1
0 	 | 	fb34 	 | 	1
0 	 | 	fb34 	 | 	1
0 	 | 	fb34 	 | 	1
0 	 | 	fb35 	 | 	1
0 	 | 	fb36 	 | 	1
0 	 | 	fb36 	 | 	1
0 	 | 	fb37 	 | 	1
0 	 | 	fb37 	 | 	1
0 	 | 	fb38 	 | 	1
0 	 | 	fb39 	 | 	1
0 	 | 	fb40 	 | 	1
0 	 | 	fb40 	 | 	1
0 	 | 	fb41 	 | 	1
0 	 | 	fb41 	 | 	1
0 	 | 	fb41 	 | 	1
0 	 | 	fb41 	 | 	1
0 	 | 	fb41 	 | 	1
0 	 | 	fb41 	 | 	1
0 	 | 	fb42 	 | 	1
0 	 | 	fb42 	 | 	1
0 	 | 	fb42 	 | 	1
0 	 | 	fb43 	 | 	1
0 	 | 	fb43 	 | 	1
0 	 | 	fb43 	 | 	1
0 	 | 	fb44 	 | 	1
0 	 | 	fb44 	 | 	1
0 	 | 	fb45 	 | 	1
0 	 | 	fb45 	 | 	1
0 	 | 	fb45 	 | 	1
0 	 | 	fb46 	 | 	1
0 	 | 	fb46 	 | 	1
0 	 | 	fb47 	 | 	1
0 	 | 	fb47 	 | 	1
0 	 | 	fb47 	 | 	1
0 	 | 	fb47 	 | 	1
0 	 | 	fb47 	 | 	1
0 	 | 	fb47 	 | 	1
0 	 | 	fb48 	 | 	1
0 	 | 	fb49 	 | 	1
0 	 | 	fb50 	 | 	1
0 	 | 	fb51 	 | 	1
0 	 | 	fb51 	 | 	1
0 	 | 	fb51 	 | 	1
0 	 | 	fb51 	 | 	1
0 	 | 	fb51 	 | 	1
0 	 | 	fb51 	 | 	1
0 	 | 	fb51 	 | 	1
0 	 | 	fb51 	 | 	1
0 	 | 	fb51 	 | 	1
0 	 | 	fb52 	 | 	1
0 	 | 	fb52 	 | 	1
0 	 | 	fb53 	 | 	1
0 	 | 	fb54 	 | 	1
0 	 | 	fb54 	 | 	1
0 	 | 	fb55 	 | 	1
0 	 | 	fb55 	 | 	1
0 	 | 	fb56 	 | 	1
0 	 | 	fb57 	 | 	1
0 	 | 	fb58 	 | 	1
0 	 | 	fb58 	 | 	1
0 	 | 	fb59 	 | 	1
0 	 | 	fb60 	 | 	1
0 	 | 	fb60 	 | 	1
0 	 | 	fb60 	 | 	1
0 	 | 	fb61 	 | 	1
0 	 | 	fb61 	 | 	1
0 	 | 	fb61 	 | 	1
0 	 | 	fb61 	 | 	1
0 	 | 	fb61 	 | 	1
0 	 | 	fb61 	 | 	1
0 	 | 	fb61 	 | 	1
0 	 | 	fb62 	 | 	1
0 	 | 	fb63 	 | 	1
0 	 | 	fb64 	 | 	1
0 	 | 	fb64 	 | 	1
1607 	 | 	fb55 	 | 	0
1792 	 | 	fb31 	 | 	0
1819 	 | 	fb64 	 | 	0
2023 	 | 	fb47 	 | 	0
2152 	 | 	fb20 	 | 	0
2532 	 | 	fb52 	 | 	0
2705 	 | 	fb50 	 | 	0
3261 	 | 	fb59 	 | 	0
4553 	 | 	fb21 	 | 	0
4777 	 | 	fb52 	 | 	1
4951 	 | 	fb14 	 | 	0
5511 	 | 	fb38 	 | 	0
5984 	 | 	fb47 	 | 	1
6116 	 | 	fb43 	 | 	0
6500 	 | 	fb11 	 | 	0
6913 	 | 	fb64 	 | 	1
6920 	 | 	fb56 	 | 	0
7193 	 | 	fb3 	 | 	0
7297 	 | 	fb62 	 | 	0
7346 	 | 	fb42 	 | 	0
7470 	 | 	fb34 	 | 	0
7761 	 | 	fb60 	 | 	0
8418 	 | 	fb61 	 | 	0
8800 	 | 	fb27 	 | 	0
9203 	 | 	fb47 	 | 	0
9770 	 | 	fb48 	 | 	0
10512 	 | 	fb20 	 | 	1
11136 	 | 	fb42 	 | 	1
11236 	 | 	fb6 	 | 	0
11308 	 | 	fb55 	 | 	1
11604 	 | 	fb35 	 | 	0
11879 	 | 	fb25 	 | 	0
12003 	 | 	fb59 	 | 	1
12257 	 | 	fb15 	 | 	0
12974 	 | 	fb60 	 | 	1
14147 	 | 	fb7 	 | 	0
14931 	 | 	fb38 	 | 	1
14958 	 | 	fb3 	 | 	1
15632 	 | 	fb61 	 | 	1
16085 	 | 	fb53 	 | 	0
16218 	 | 	fb24 	 | 	0
16277 	 | 	fb43 	 | 	1
16440 	 | 	fb19 	 | 	0
16584 	 | 	fb20 	 | 	0
16712 	 | 	fb63 	 | 	0
16974 	 | 	fb35 	 | 	1
17147 	 | 	fb21 	 | 	1
17211 	 | 	fb27 	 | 	1
17653 	 | 	fb62 	 | 	1
18219 	 | 	fb19 	 | 	1
18325 	 | 	fb33 	 | 	0
19119 	 | 	fb37 	 | 	0
