---- 	   	Begin Recorded Data	   	 ---- 
time 	 | 	robot 	| 	 goal 
1 = target	 0 = base 
 
0 	 | 	fb1 	 | 	1
0 	 | 	fb2 	 | 	1
0 	 | 	fb3 	 | 	1
0 	 | 	fb4 	 | 	1
0 	 | 	fb5 	 | 	1
0 	 | 	fb5 	 | 	1
0 	 | 	fb6 	 | 	1
0 	 | 	fb7 	 | 	1
0 	 | 	fb8 	 | 	1
0 	 | 	fb9 	 | 	1
0 	 | 	fb10 	 | 	1
0 	 | 	fb11 	 | 	1
0 	 | 	fb12 	 | 	1
0 	 | 	fb13 	 | 	1
0 	 | 	fb14 	 | 	1
0 	 | 	fb14 	 | 	1
0 	 | 	fb15 	 | 	1
0 	 | 	fb15 	 | 	1
0 	 | 	fb15 	 | 	1
0 	 | 	fb15 	 | 	1
0 	 | 	fb15 	 | 	1
0 	 | 	fb15 	 | 	1
0 	 | 	fb15 	 | 	1
0 	 | 	fb16 	 | 	1
0 	 | 	fb17 	 | 	1
0 	 | 	fb18 	 | 	1
0 	 | 	fb19 	 | 	1
0 	 | 	fb19 	 | 	1
0 	 | 	fb19 	 | 	1
0 	 | 	fb20 	 | 	1
0 	 | 	fb20 	 | 	1
0 	 | 	fb20 	 | 	1
0 	 | 	fb21 	 | 	1
0 	 | 	fb22 	 | 	1
0 	 | 	fb22 	 | 	1
0 	 | 	fb23 	 | 	1
0 	 | 	fb24 	 | 	1
0 	 | 	fb24 	 | 	1
0 	 | 	fb25 	 | 	1
0 	 | 	fb26 	 | 	1
0 	 | 	fb27 	 | 	1
0 	 | 	fb27 	 | 	1
0 	 | 	fb28 	 | 	1
0 	 | 	fb29 	 | 	1
0 	 | 	fb30 	 | 	1
0 	 | 	fb30 	 | 	1
0 	 | 	fb31 	 | 	1
0 	 | 	fb32 	 | 	1
0 	 | 	fb32 	 | 	1
0 	 | 	fb33 	 | 	1
0 	 | 	fb33 	 | 	1
0 	 | 	fb33 	 | 	1
0 	 | 	fb33 	 | 	1
0 	 | 	fb34 	 | 	1
0 	 | 	fb35 	 | 	1
0 	 | 	fb36 	 | 	1
0 	 | 	fb36 	 | 	1
0 	 | 	fb36 	 | 	1
0 	 | 	fb36 	 | 	1
0 	 | 	fb37 	 | 	1
0 	 | 	fb38 	 | 	1
0 	 | 	fb39 	 | 	1
0 	 | 	fb39 	 | 	1
0 	 | 	fb40 	 | 	1
0 	 | 	fb40 	 | 	1
0 	 | 	fb40 	 | 	1
0 	 | 	fb40 	 | 	1
0 	 | 	fb41 	 | 	1
0 	 | 	fb42 	 | 	1
0 	 | 	fb43 	 | 	1
0 	 | 	fb43 	 | 	1
0 	 | 	fb44 	 | 	1
0 	 | 	fb45 	 | 	1
0 	 | 	fb46 	 | 	1
0 	 | 	fb46 	 | 	1
0 	 | 	fb47 	 | 	1
0 	 | 	fb47 	 | 	1
0 	 | 	fb47 	 | 	1
0 	 | 	fb48 	 | 	1
0 	 | 	fb48 	 | 	1
0 	 | 	fb48 	 | 	1
0 	 | 	fb48 	 | 	1
0 	 | 	fb49 	 | 	1
0 	 | 	fb50 	 | 	1
0 	 | 	fb50 	 | 	1
0 	 | 	fb50 	 | 	1
0 	 | 	fb50 	 | 	1
0 	 | 	fb50 	 | 	1
0 	 | 	fb50 	 | 	1
0 	 | 	fb50 	 | 	1
0 	 | 	fb50 	 | 	1
0 	 | 	fb50 	 | 	1
0 	 | 	fb50 	 | 	1
0 	 | 	fb51 	 | 	1
0 	 | 	fb52 	 | 	1
0 	 | 	fb53 	 | 	1
0 	 | 	fb54 	 | 	1
0 	 | 	fb54 	 | 	1
0 	 | 	fb55 	 | 	1
0 	 | 	fb55 	 | 	1
0 	 | 	fb55 	 | 	1
0 	 | 	fb56 	 | 	1
0 	 | 	fb56 	 | 	1
0 	 | 	fb56 	 | 	1
0 	 | 	fb56 	 | 	1
0 	 | 	fb56 	 | 	1
0 	 | 	fb57 	 | 	1
0 	 | 	fb57 	 | 	1
0 	 | 	fb57 	 | 	1
0 	 | 	fb57 	 | 	1
0 	 | 	fb58 	 | 	1
0 	 | 	fb58 	 | 	1
0 	 | 	fb58 	 | 	1
0 	 | 	fb58 	 | 	1
0 	 | 	fb58 	 | 	1
0 	 | 	fb58 	 | 	1
0 	 | 	fb58 	 | 	1
0 	 | 	fb58 	 | 	1
0 	 | 	fb58 	 | 	1
0 	 | 	fb59 	 | 	1
0 	 | 	fb60 	 | 	1
0 	 | 	fb61 	 | 	1
0 	 | 	fb61 	 | 	1
0 	 | 	fb62 	 | 	1
0 	 | 	fb63 	 | 	1
0 	 | 	fb63 	 | 	1
0 	 | 	fb63 	 | 	1
0 	 | 	fb63 	 | 	1
0 	 | 	fb63 	 | 	1
0 	 | 	fb63 	 | 	1
0 	 | 	fb63 	 | 	1
0 	 | 	fb63 	 | 	1
0 	 | 	fb63 	 | 	1
0 	 | 	fb63 	 | 	1
0 	 | 	fb63 	 | 	1
0 	 | 	fb64 	 | 	1
0 	 | 	fb64 	 | 	1
4236 	 | 	fb14 	 | 	0
5514 	 | 	fb30 	 | 	0
5813 	 | 	fb5 	 | 	0
5818 	 | 	fb18 	 | 	0
6044 	 | 	fb31 	 | 	0
6520 	 | 	fb1 	 | 	0
6647 	 | 	fb49 	 | 	0
6726 	 | 	fb15 	 | 	0
6801 	 | 	fb56 	 | 	0
6880 	 | 	fb25 	 | 	0
6951 	 | 	fb61 	 | 	0
6971 	 | 	fb13 	 | 	0
7087 	 | 	fb54 	 | 	0
8494 	 | 	fb23 	 | 	0
9203 	 | 	fb57 	 | 	0
9412 	 | 	fb35 	 | 	0
9555 	 | 	fb52 	 | 	0
9569 	 | 	fb19 	 | 	0
10016 	 | 	fb10 	 | 	0
10267 	 | 	fb40 	 | 	0
10624 	 | 	fb13 	 | 	1
10668 	 | 	fb49 	 | 	1
11059 	 | 	fb41 	 | 	0
11359 	 | 	fb39 	 | 	0
11599 	 | 	fb57 	 | 	1
12171 	 | 	fb31 	 | 	1
12395 	 | 	fb18 	 | 	1
12616 	 | 	fb10 	 | 	1
12798 	 | 	fb55 	 | 	0
12847 	 | 	fb16 	 | 	0
13127 	 | 	fb64 	 | 	0
13511 	 | 	fb49 	 | 	0
13619 	 | 	fb28 	 | 	0
13722 	 | 	fb51 	 | 	0
13911 	 | 	fb63 	 | 	0
13950 	 | 	fb30 	 | 	1
16340 	 | 	fb23 	 | 	1
16677 	 | 	fb9 	 | 	0
16713 	 | 	fb20 	 | 	0
17177 	 | 	fb4 	 | 	0
17257 	 | 	fb33 	 | 	0
18362 	 | 	fb44 	 | 	0
18939 	 | 	fb61 	 | 	1
19089 	 | 	fb56 	 | 	1
19558 	 | 	fb53 	 | 	0
